6 5 3 1 1 1 1 1 1 1
0 1 0 0 1 1 0 0 0 1
0 1 1 0 3 1 0 1 2 1
0 1 1 1 3 1 0 0 0 0
6 0 0 0 0 0 1 1 1 0
1 1 4 1 1 1 1 1 1 0
1 1 0 4 4 0 0 1 1 5
1 1 0 0 1 1 0 1 1 0
0 0 0 0 1 1 5 0 0 0
1 1 1 0 1 1 0 1 1 1