0 5 3 1 1 1 1 1 1 1
0 1 0 0 1 0 0 0 0 1
0 1 1 0 3 5 1 1 2 0
1 1 1 1 1 1 1 1 1 0
6 0 0 0 0 0 0 0 0 0
1 0 1 1 1 1 1 1 1 1
1 0 0 4 4 1 0 1 1 5
1 1 0 1 1 1 0 1 1 0
0 1 0 0 1 1 5 0 0 0
1 1 1 6 1 1 0 1 1 1