1 1 1 1 3 1 1 1 1 2
1 0 0 0 0 0 0 0 0 0
1 0 0 0 0 3 0 0 0 0
1 0 0 0 0 0 0 0 0 4
1 0 0 0 0 0 0 0 0 0
1 0 0 0 0 0 3 0 0 0
1 0 0 0 0 0 0 0 0 0
1 0 0 0 0 0 0 0 0 0
1 6 0 0 0 0 0 0 0 0
6 0 0 0 0 0 0 0 0 0