0 0 0 0 0 0 0 0 0 2
0 1 1 1 1 1 1 1 1 0
0 1 1 0 3 5 1 0 1 6
0 1 1 1 3 1 1 1 1 0
0 1 0 0 0 0 0 0 1 0
0 1 4 1 1 1 1 1 1 0
0 1 0 4 1 0 0 1 1 0
0 1 0 0 1 1 0 1 1 0
0 0 1 1 1 1 1 1 1 0
6 0 0 0 0 0 0 0 4 0